25 20
#############
#2....1.....#    ########
#...s...s...######......#
#.......................#
#...........######......#
#.....s.....######......#
#.......................#
#...........######......#
#####..######    ###..###
    #..#           #..#
    #..#           #..#
    #..#          ##..##
  ###..####      #......#
  #..@....#      #......#
  #.......#      #......#
  #.......#      #......#
  #.......#      #......#
  #.......#      #......#
  #.......#      #......#
  #########       ######
